summon
InternetGatewayDevice.WANDevice.1.WANConnectionDevice.1.WANPPPConnection

then
Add InternetGatewayDevice.WANDevice.1.WANConnectionDevice.1.WANPPPConnection

InternetGatewayDevice.WANDevice.1.WANConnectionDevice.1.WANPPPConnection.1  

then
Refresh 1 parameters

InternetGatewayDevice.WANDevice.1.WANConnectionDevice.1.WANPPPConnection.1	
InternetGatewayDevice.WANDevice.1.WANConnectionDevice.1.WANPPPConnection.1.AutoDisconnectTime	0
InternetGatewayDevice.WANDevice.1.WANConnectionDevice.1.WANPPPConnection.1.ConnectionStatus	Disconnected
InternetGatewayDevice.WANDevice.1.WANConnectionDevice.1.WANPPPConnection.1.ConnectionTrigger	AlwaysOn
InternetGatewayDevice.WANDevice.1.WANConnectionDevice.1.WANPPPConnection.1.ConnectionType	IP_Routed
InternetGatewayDevice.WANDevice.1.WANConnectionDevice.1.WANPPPConnection.1.CurrentMRUSize	1492
InternetGatewayDevice.WANDevice.1.WANConnectionDevice.1.WANPPPConnection.1.DNSEnabled	true
InternetGatewayDevice.WANDevice.1.WANConnectionDevice.1.WANPPPConnection.1.DNSOverrideAllowed	false
InternetGatewayDevice.WANDevice.1.WANConnectionDevice.1.WANPPPConnection.1.DNSServers	
InternetGatewayDevice.WANDevice.1.WANConnectionDevice.1.WANPPPConnection.1.DefaultGateway	0.0.0.0
InternetGatewayDevice.WANDevice.1.WANConnectionDevice.1.WANPPPConnection.1.Enable	true
InternetGatewayDevice.WANDevice.1.WANConnectionDevice.1.WANPPPConnection.1.ExternalIPAddress	0.0.0.0
InternetGatewayDevice.WANDevice.1.WANConnectionDevice.1.WANPPPConnection.1.IdleDisconnectTime	180
InternetGatewayDevice.WANDevice.1.WANConnectionDevice.1.WANPPPConnection.1.LastConnectionError	ERROR_NONE
InternetGatewayDevice.WANDevice.1.WANConnectionDevice.1.WANPPPConnection.1.MACAddress	04:33:89:74:47:08
InternetGatewayDevice.WANDevice.1.WANConnectionDevice.1.WANPPPConnection.1.MACAddressOverride	false
InternetGatewayDevice.WANDevice.1.WANConnectionDevice.1.WANPPPConnection.1.MaxMRUSize	1492
InternetGatewayDevice.WANDevice.1.WANConnectionDevice.1.WANPPPConnection.1.NATEnabled	false
InternetGatewayDevice.WANDevice.1.WANConnectionDevice.1.WANPPPConnection.1.Name	2_INTERNET_R_VID_1
InternetGatewayDevice.WANDevice.1.WANConnectionDevice.1.WANPPPConnection.1.PPPAuthenticationProtocol	PAP
InternetGatewayDevice.WANDevice.1.WANConnectionDevice.1.WANPPPConnection.1.PPPCompressionProtocol	None
InternetGatewayDevice.WANDevice.1.WANConnectionDevice.1.WANPPPConnection.1.PPPEncryptionProtocol	None
InternetGatewayDevice.WANDevice.1.WANConnectionDevice.1.WANPPPConnection.1.PPPLCPEcho	30
InternetGatewayDevice.WANDevice.1.WANConnectionDevice.1.WANPPPConnection.1.PPPLCPEchoRetry	6
InternetGatewayDevice.WANDevice.1.WANConnectionDevice.1.WANPPPConnection.1.PPPoEACName	
InternetGatewayDevice.WANDevice.1.WANConnectionDevice.1.WANPPPConnection.1.PPPoEServiceName	
InternetGatewayDevice.WANDevice.1.WANConnectionDevice.1.WANPPPConnection.1.PPPoESessionID	1
InternetGatewayDevice.WANDevice.1.WANConnectionDevice.1.WANPPPConnection.1.Password	
InternetGatewayDevice.WANDevice.1.WANConnectionDevice.1.WANPPPConnection.1.PortMapping	
InternetGatewayDevice.WANDevice.1.WANConnectionDevice.1.WANPPPConnection.1.PortMappingNumberOfEntries	0
InternetGatewayDevice.WANDevice.1.WANConnectionDevice.1.WANPPPConnection.1.PossibleConnectionTypes	IP_Routed,PPPoE_Bridged
InternetGatewayDevice.WANDevice.1.WANConnectionDevice.1.WANPPPConnection.1.RSIPAvailable	false
InternetGatewayDevice.WANDevice.1.WANConnectionDevice.1.WANPPPConnection.1.RemoteIPAddress	
InternetGatewayDevice.WANDevice.1.WANConnectionDevice.1.WANPPPConnection.1.Reset	false
InternetGatewayDevice.WANDevice.1.WANConnectionDevice.1.WANPPPConnection.1.RouteProtocolRx	Off
InternetGatewayDevice.WANDevice.1.WANConnectionDevice.1.WANPPPConnection.1.ShapingBurstSize	0
InternetGatewayDevice.WANDevice.1.WANConnectionDevice.1.WANPPPConnection.1.ShapingRate	-1
InternetGatewayDevice.WANDevice.1.WANConnectionDevice.1.WANPPPConnection.1.Stats	
InternetGatewayDevice.WANDevice.1.WANConnectionDevice.1.WANPPPConnection.1.TransportType	PPPoE
InternetGatewayDevice.WANDevice.1.WANConnectionDevice.1.WANPPPConnection.1.Uptime	0
InternetGatewayDevice.WANDevice.1.WANConnectionDevice.1.WANPPPConnection.1.Username	
InternetGatewayDevice.WANDevice.1.WANConnectionDevice.1.WANPPPConnection.1.WarnDisconnectDelay	0
InternetGatewayDevice.WANDevice.1.WANConnectionDevice.1.WANPPPConnection.1.X_HW_6RDTunnel	
InternetGatewayDevice.WANDevice.1.WANConnectionDevice.1.WANPPPConnection.1.X_HW_DDNSConfiguration	
InternetGatewayDevice.WANDevice.1.WANConnectionDevice.1.WANPPPConnection.1.X_HW_DMZ	
InternetGatewayDevice.WANDevice.1.WANConnectionDevice.1.WANPPPConnection.1.X_HW_DefaultPri	0
InternetGatewayDevice.WANDevice.1.WANConnectionDevice.1.WANPPPConnection.1.X_HW_Dnsv4ProxyForV6	false
InternetGatewayDevice.WANDevice.1.WANConnectionDevice.1.WANPPPConnection.1.X_HW_DscpToPbitTbl	
InternetGatewayDevice.WANDevice.1.WANConnectionDevice.1.WANPPPConnection.1.X_HW_ExServiceList	
InternetGatewayDevice.WANDevice.1.WANConnectionDevice.1.WANPPPConnection.1.X_HW_IPv4Enable	true
InternetGatewayDevice.WANDevice.1.WANConnectionDevice.1.WANPPPConnection.1.X_HW_IPv6	
InternetGatewayDevice.WANDevice.1.WANConnectionDevice.1.WANPPPConnection.1.X_HW_IPv6Enable	false
InternetGatewayDevice.WANDevice.1.WANConnectionDevice.1.WANPPPConnection.1.X_HW_IPv6MultiCastVLAN	-1
InternetGatewayDevice.WANDevice.1.WANConnectionDevice.1.WANPPPConnection.1.X_HW_IPv6_PortForwardNumberOfEntries	0
InternetGatewayDevice.WANDevice.1.WANConnectionDevice.1.WANPPPConnection.1.X_HW_IdleDetectMode	DetectBidirectionally
InternetGatewayDevice.WANDevice.1.WANConnectionDevice.1.WANPPPConnection.1.X_HW_LANBIND	
InternetGatewayDevice.WANDevice.1.WANConnectionDevice.1.WANPPPConnection.1.X_HW_LcpEchoReqCheck	false
InternetGatewayDevice.WANDevice.1.WANConnectionDevice.1.WANPPPConnection.1.X_HW_LowerLayers	
InternetGatewayDevice.WANDevice.1.WANConnectionDevice.1.WANPPPConnection.1.X_HW_MultiCastVLAN	4294967295
InternetGatewayDevice.WANDevice.1.WANConnectionDevice.1.WANPPPConnection.1.X_HW_NatType	0
InternetGatewayDevice.WANDevice.1.WANConnectionDevice.1.WANPPPConnection.1.X_HW_PRI	0
InternetGatewayDevice.WANDevice.1.WANConnectionDevice.1.WANPPPConnection.1.X_HW_PortTrigger	
InternetGatewayDevice.WANDevice.1.WANConnectionDevice.1.WANPPPConnection.1.X_HW_PriPolicy	Specified
InternetGatewayDevice.WANDevice.1.WANConnectionDevice.1.WANPPPConnection.1.X_HW_RouteProtocolAuthKey	
InternetGatewayDevice.WANDevice.1.WANConnectionDevice.1.WANPPPConnection.1.X_HW_RouteProtocolAuthMode	Off
InternetGatewayDevice.WANDevice.1.WANConnectionDevice.1.WANPPPConnection.1.X_HW_RouteProtocolRxMode	Passive
InternetGatewayDevice.WANDevice.1.WANConnectionDevice.1.WANPPPConnection.1.X_HW_SERVICELIST	INTERNET
InternetGatewayDevice.WANDevice.1.WANConnectionDevice.1.WANPPPConnection.1.X_HW_UpstreamWAN	false
InternetGatewayDevice.WANDevice.1.WANConnectionDevice.1.WANPPPConnection.1.X_HW_VLAN	1
InternetGatewayDevice.WANDevice.1.WANConnectionDevice.1.WANPPPConnectionNumberOfEntries
